{
  "metadata": {
    "stage": 2,
    "strategy": {
      "target_images": 25000,
      "target_classes": 237,
      "images_per_class": 105,
      "selection_method": "actual_ssd_data_top_images",
      "seed": 42
    },
    "timestamp": "2025-08-20T11:20:00",
    "selected_classes": [
      "K-022465",
      "K-022706",
      "K-019904",
      "K-022095",
      "K-020014",
      "K-020401",
      "K-023425",
      "K-022978",
      "K-024397",
      "K-023357",
      "K-023084",
      "K-024279",
      "K-024162",
      "K-023310",
      "K-023405",
      "K-022963",
      "K-026281",
      "K-025648",
      "K-025458",
      "K-025828",
      "K-027188",
      "K-025189",
      "K-026894",
      "K-026545",
      "K-027735",
      "K-028052",
      "K-027737",
      "K-027926",
      "K-027338",
      "K-027436",
      "K-029534",
      "K-029451",
      "K-028423",
      "K-029872",
      "K-027733",
      "K-027602",
      "K-028074",
      "K-029206",
      "K-031876",
      "K-031179",
      "K-031178",
      "K-030053",
      "K-030957",
      "K-030063",
      "K-032900",
      "K-032158",
      "K-033406",
      "K-033880",
      "K-033059",
      "K-033830",
      "K-032376",
      "K-032243",
      "K-036163",
      "K-037578",
      "K-037029",
      "K-037298",
      "K-035206",
      "K-034827",
      "K-035837",
      "K-038622",
      "K-040333",
      "K-039137",
      "K-038262",
      "K-039150",
      "K-038245",
      "K-040336",
      "K-038972",
      "K-040215",
      "K-040639",
      "K-042340",
      "K-043814",
      "K-043670",
      "K-041692",
      "K-041293",
      "K-043250",
      "K-040622",
      "K-042269",
      "K-045403",
      "K-046427",
      "K-043946",
      "K-045103",
      "K-044660",
      "K-045067",
      "K-044395",
      "K-045658",
      "K-001029",
      "K-000818",
      "K-001061",
      "K-000122",
      "K-000479",
      "K-049501",
      "K-050264",
      "K-051295",
      "K-049556",
      "K-052716",
      "K-049905",
      "K-050144",
      "K-051115",
      "K-052958",
      "K-059525",
      "K-000117",
      "K-000167",
      "K-000492",
      "K-001756",
      "K-001628",
      "K-001731",
      "K-001449",
      "K-003351",
      "K-002754",
      "K-003726",
      "K-004153",
      "K-004326",
      "K-005856",
      "K-002537",
      "K-002160",
      "K-002495",
      "K-002753",
      "K-003361",
      "K-002186",
      "K-002005",
      "K-001715",
      "K-003157",
      "K-002650",
      "K-006854",
      "K-007508",
      "K-009023",
      "K-008441",
      "K-011234",
      "K-012512",
      "K-012382",
      "K-003708",
      "K-005849",
      "K-004632",
      "K-005091",
      "K-003727",
      "K-005223",
      "K-004489",
      "K-004119",
      "K-005208",
      "K-014088",
      "K-013867",
      "K-015266",
      "K-016249",
      "K-016232",
      "K-019314",
      "K-007061",
      "K-007143",
      "K-007638",
      "K-007588",
      "K-006563",
      "K-007060",
      "K-007447",
      "K-007144",
      "K-006284",
      "K-006273",
      "K-020853",
      "K-020451",
      "K-020878",
      "K-022977",
      "K-023218",
      "K-024127",
      "K-023860",
      "K-024101",
      "K-024850",
      "K-025519",
      "K-008014",
      "K-007947",
      "K-008834",
      "K-008900",
      "K-008899",
      "K-010225",
      "K-008996",
      "K-008234",
      "K-008976",
      "K-009552",
      "K-010408",
      "K-009432",
      "K-008123",
      "K-009459",
      "K-027194",
      "K-027897",
      "K-029205",
      "K-029672",
      "K-029430",
      "K-029383",
      "K-029429",
      "K-030062",
      "K-029774",
      "K-030992",
      "K-031680",
      "K-031258",
      "K-011541",
      "K-011695",
      "K-011647",
      "K-010955",
      "K-011783",
      "K-011274",
      "K-010528",
      "K-011543",
      "K-011617",
      "K-010545",
      "K-032658",
      "K-033309",
      "K-033878",
      "K-034499",
      "K-034978",
      "K-035326",
      "K-035593",
      "K-037553",
      "K-012447",
      "K-012192",
      "K-012758",
      "K-013256",
      "K-012416",
      "K-012501",
      "K-012564",
      "K-013263",
      "K-012080",
      "K-039136",
      "K-014567",
      "K-015499",
      "K-014280",
      "K-015258",
      "K-014251",
      "K-016230",
      "K-014279",
      "K-014317",
      "K-015989",
      "K-016645",
      "K-018720",
      "K-018305",
      "K-016736",
      "K-016912",
      "K-018114",
      "K-017713",
      "K-018203",
      "K-017714"
    ]
  }
}